4,4,4,1,1,3,5,5,4,6,6,4,4,2,1
2,4,5,1,4,3,2,5,4,3,6,1,4,5,4
4,4,5,1,4,3,2,5,4,3,6,1,4,5,2
6,4,5,1,4,3,2,5,4,3,6,1,4,5,2
3,4,5,1,4,3,2,5,3,3,6,1,4,5,4
1,4,5,1,4,3,2,5,4,3,6,1,4,5,5
1,4,5,1,4,3,2,5,4,3,6,1,4,5,5
1,4,5,1,4,3,2,5,4,3,6,1,4,5,2
4,4,5,1,4,3,2,5,4,3,6,1,4,5,5
1,5,5,5,4,4,2,4,4,3,1,1,5,5,4
